Time,Team,Operation,BuyVolume,SellVolume,EtfPosition,FuturePosition,EtfPrice,FuturePrice,TotalFees,AccountBalance,ProfitOrLoss,Status
1e-06,TraderOne,Tick,0,0,0,0,,,0,0,0,OK
0.269569,TraderOne,Tick,0,0,0,0,,,0,0,0,OK
0.517344,TraderOne,Tick,0,0,0,0,,,0,0,0,OK
0.79858,TraderOne,Tick,0,10,-10,10,147600,,-147,147,147,OK
1.033407,TraderOne,Tick,0,10,-10,10,147600,147100,-147,147,-1853,OK
1.257367,TraderOne,Tick,1,10,-9,9,147000,147100,-162,262,1162,OK
1.522924,TraderOne,Tick,1,10,-9,9,147000,147100,-162,262,1162,OK
1.721889,TraderOne,Tick,1,10,-9,9,147000,147100,-162,262,1162,OK
1.982432,TraderOne,Tick,1,10,-9,9,147000,147100,-162,262,1162,OK
2.216777,TraderOne,Tick,1,10,-9,9,147000,146900,-162,262,-638,OK
2.472568,TraderOne,Tick,1,10,-9,9,147000,146900,-162,262,-638,OK
2.787552,TraderOne,Tick,11,10,1,-1,146400,146900,-309,-1591,-1791,OK
2.981907,TraderOne,Tick,11,10,1,-1,146400,146900,-309,-1591,-1791,OK
3.253378,TraderOne,Tick,11,10,1,-1,146400,146900,-309,-1591,-1791,OK
3.54876,TraderOne,Tick,11,20,-9,9,147500,146900,-456,-1444,-3244,OK
3.742301,TraderOne,Tick,21,20,1,-1,146300,146900,-603,-2297,-2497,OK
4.027234,TraderOne,Tick,21,20,1,-1,146300,146900,-603,-2297,-2497,OK
4.240656,TraderOne,Tick,21,20,1,-1,146300,146900,-603,-2297,-2497,OK
4.494553,TraderOne,Tick,21,20,1,-1,146300,146900,-603,-2297,-2497,OK
4.735289,TraderOne,Tick,31,20,11,-11,146300,146900,-750,-2150,-4350,OK
5.046911,TraderOne,Tick,31,20,11,-11,146300,146900,-750,-2150,-4350,OK
5.205399,TraderOne,Tick,31,20,11,-11,146300,146800,-750,-2150,-4350,OK
5.519956,TraderOne,Tick,31,20,11,-11,146300,146800,-750,-2150,-4350,OK
5.751401,TraderOne,Tick,31,20,11,-11,146300,146800,-750,-2150,-4350,OK
6.042238,TraderOne,Tick,31,30,1,-1,147000,146800,-456,-2444,-2244,OK
6.29114,TraderOne,Tick,31,40,-9,9,147000,146800,-162,-1738,-3538,OK
6.527288,TraderOne,Tick,31,50,-19,19,147000,146800,132,968,-2832,OK
6.78986,TraderOne,Tick,31,60,-29,29,147200,146700,426,3674,-2126,OK
6.969405,TraderOne,Tick,31,60,-29,29,147200,146900,426,3674,-2126,OK
7.219556,TraderOne,Tick,31,60,-29,29,147200,146900,426,3674,-2126,OK
7.548249,TraderOne,Tick,31,60,-29,29,147200,146900,426,3674,-2126,OK
7.774483,TraderOne,Tick,31,60,-29,29,147200,146900,426,3674,-2126,OK
7.984321,TraderOne,Tick,31,60,-29,29,147200,146900,426,3674,-2126,OK
8.213049,TraderOne,Tick,41,60,-19,19,147000,146900,279,821,-1079,OK
8.523058,TraderOne,Tick,41,60,-19,19,147000,146900,279,821,-1079,OK
8.797507,TraderOne,Tick,41,60,-19,19,147000,146900,279,821,-1079,OK
9.015497,TraderOne,Tick,51,60,-9,9,146700,146900,132,-1032,768,OK
9.251155,TraderOne,Tick,61,60,1,-1,146400,146900,425,1675,1475,OK
9.455663,TraderOne,Tick,71,60,11,-11,146400,146900,718,4382,2182,OK
9.725075,TraderOne,Tick,81,60,21,-21,146400,146900,1011,6089,1889,OK
9.966826,TraderOne,Tick,81,60,21,-21,146400,146900,1011,6089,1889,OK
10.263801,TraderOne,Tick,91,60,31,-31,146400,146900,1304,7796,1596,OK
10.466476,TraderOne,Tick,101,60,41,-41,146400,146900,1597,11503,3303,OK
10.799316,TraderOne,Tick,111,70,41,-41,146500,147000,1744,8356,156,OK
10.983774,TraderOne,Tick,111,70,41,-41,147300,147000,1744,8356,16556,OK
11.256746,TraderOne,Tick,111,70,41,-41,147300,147000,1744,8356,16556,OK
11.490488,TraderOne,Tick,111,70,41,-41,147300,147000,1744,8356,16556,OK
11.750779,TraderOne,Tick,111,70,41,-41,147300,147200,1744,8356,12456,OK
12.014415,TraderOne,Tick,111,80,31,-31,147400,147200,1597,5503,11703,OK
12.255155,TraderOne,Tick,111,80,31,-31,147400,147200,1597,5503,11703,OK
12.501137,TraderOne,Tick,111,80,31,-31,147400,147200,1597,5503,11703,OK
12.720187,TraderOne,Tick,111,80,31,-31,147400,147200,1597,5503,11703,OK
13.046668,TraderOne,Tick,111,80,31,-31,147400,147200,1597,5503,11703,OK
13.296004,TraderOne,Tick,111,80,31,-31,146600,147200,1597,5503,-697,OK
13.453438,TraderOne,Tick,111,80,31,-31,146600,147200,1597,5503,-697,OK
13.734664,TraderOne,Tick,111,80,31,-31,146600,147200,1597,5503,-697,OK
14.040744,TraderOne,Tick,111,80,31,-31,146600,147200,1597,5503,-697,OK
14.242519,TraderOne,Tick,111,80,31,-31,146600,147200,1597,5503,-697,OK
14.460411,TraderOne,Tick,111,80,31,-31,146600,147200,1597,5503,-697,OK
14.750513,TraderOne,Tick,111,80,31,-31,146600,147200,1597,5503,-697,OK
14.986243,TraderOne,Tick,111,80,31,-31,146600,147200,1597,5503,-697,OK
15.274036,TraderOne,Tick,111,80,31,-31,146600,147200,1597,5503,-697,OK
15.454334,TraderOne,Tick,111,90,21,-21,146900,146800,1450,2650,4750,OK
15.734984,TraderOne,Tick,111,100,11,-11,146600,146800,1743,357,-1843,OK
15.963683,TraderOne,Tick,111,110,1,-1,146900,146900,1596,-2496,-2496,OK
16.223215,TraderOne,Tick,111,110,1,-1,146900,146900,1596,-2496,-2496,OK
16.534588,TraderOne,Tick,111,110,1,-1,146900,146900,1596,-2496,-2496,OK
16.701158,TraderOne,Tick,111,110,1,-1,146900,146900,1596,-2496,-2496,OK
16.958298,TraderOne,Tick,111,110,1,-1,146900,146900,1596,-2496,-2496,OK
17.284635,TraderOne,Tick,111,110,1,-1,146900,146900,1596,-2496,-2496,OK
17.544423,TraderOne,Tick,111,110,1,-1,146900,146900,1596,-2496,-2496,OK
17.744355,TraderOne,Tick,121,110,11,-11,146900,146900,1890,-1790,-1790,OK
18.040333,TraderOne,Tick,131,110,21,-21,146600,146900,2184,-1084,-5284,OK
18.286121,TraderOne,Tick,131,110,21,-21,146600,146900,2184,-1084,-5284,OK
18.545856,TraderOne,Tick,131,110,21,-21,146600,147100,2184,-1084,-5284,OK
18.741651,TraderOne,Tick,131,110,21,-21,146600,147100,2184,-1084,-5284,OK
18.955379,TraderOne,Tick,131,110,21,-21,146600,147100,2184,-1084,-5284,OK
19.245038,TraderOne,Tick,131,110,21,-21,146600,147100,2184,-1084,-5284,OK
19.487851,TraderOne,Tick,131,110,21,-21,146600,147200,2184,-1084,-5284,OK
19.767488,TraderOne,Tick,141,110,31,-31,146900,147200,2478,622,-5578,OK
20.041467,TraderOne,Tick,141,110,31,-31,146900,147200,2478,622,-5578,OK
20.214356,TraderOne,Tick,151,110,41,-41,146900,147200,2772,3328,-4872,OK
20.464345,TraderOne,Tick,161,110,51,-51,146900,147900,3066,8034,-2166,OK
20.761523,TraderOne,Tick,171,120,51,-51,147500,147900,3213,10887,687,OK
20.979467,TraderOne,Tick,171,130,41,-41,147600,147900,3508,7592,-608,OK
21.276386,TraderOne,Tick,171,136,35,-35,147600,147900,3685,5615,-1385,OK
21.453393,TraderOne,Tick,171,136,35,-35,147600,147900,3685,5615,-1385,OK
21.795975,TraderOne,Tick,171,136,35,-35,147600,147900,3685,5615,-1385,OK
21.971995,TraderOne,Tick,171,136,35,-35,147600,148000,3685,5615,-1385,OK
22.275349,TraderOne,Tick,181,136,45,-45,147700,148000,3980,7320,-1680,OK
22.454156,TraderOne,Tick,181,136,45,-45,147700,148100,3980,7320,-1680,OK
22.762216,TraderOne,Tick,191,136,55,-55,147700,148100,4275,10025,-975,OK
22.966305,TraderOne,Tick,191,146,45,-45,147600,148000,4570,4730,-4270,OK
23.233794,TraderOne,Tick,191,146,45,-45,147600,148000,4570,4730,-4270,OK
23.53363,TraderOne,Tick,191,156,35,-35,147400,147700,4865,1435,-5565,OK
23.74006,TraderOne,Tick,191,156,35,-35,147400,147700,4865,1435,-5565,OK
24.004582,TraderOne,Tick,191,156,35,-35,147400,147700,4865,1435,-5565,OK
24.220135,TraderOne,Tick,201,156,45,-45,147400,147700,5160,4140,-4860,OK
24.475624,TraderOne,Tick,201,156,45,-45,147400,147700,5160,4140,-4860,OK
24.763864,TraderOne,Tick,211,156,55,-55,147400,148100,5455,8845,-2155,OK
24.999728,TraderOne,Tick,211,156,55,-55,147400,148100,5455,8845,-2155,OK
25.206949,TraderOne,Tick,221,156,65,-65,147700,148200,5750,13550,550,OK
25.520997,TraderOne,Tick,221,166,55,-55,147600,147900,6045,7255,-3745,OK
25.796707,TraderOne,Tick,221,173,48,-48,147600,147900,5942,3858,-5742,OK
26.047651,TraderOne,Tick,221,173,48,-48,147600,147900,5942,3858,-5742,OK
26.21839,TraderOne,Tick,221,173,48,-48,147600,147900,5942,3858,-5742,OK
26.474743,TraderOne,Tick,221,173,48,-48,147400,147900,5942,3858,-5742,OK
26.730326,TraderOne,Tick,221,173,48,-48,147400,147900,5942,3858,-5742,OK
27.005427,TraderOne,Tick,221,173,48,-48,147400,147900,5942,3858,-5742,OK
27.2072,TraderOne,Tick,231,173,58,-58,147400,147900,5794,8006,-3594,OK
27.455418,TraderOne,Tick,231,173,58,-58,147400,147900,5794,8006,-3594,OK
27.704988,TraderOne,Tick,231,173,58,-58,147400,147900,5794,8006,-3594,OK
28.028374,TraderOne,Tick,241,183,58,-58,147200,147800,5499,8301,-3299,OK
28.295032,TraderOne,Tick,241,183,58,-58,147200,147800,5499,8301,-3299,OK
28.550215,TraderOne,Tick,241,193,48,-48,147700,147800,5352,4448,-352,OK
28.760943,TraderOne,Tick,241,193,48,-48,147700,147600,5352,4448,9248,OK
28.954364,TraderOne,Tick,241,193,48,-48,147700,147600,5352,4448,9248,OK
29.257772,TraderOne,Tick,241,193,48,-48,147700,147600,5352,4448,9248,OK
29.528446,TraderOne,Tick,241,193,48,-48,147700,147600,5352,4448,9248,OK
29.722974,TraderOne,Tick,241,203,38,-38,147100,147600,5646,1154,-6446,OK
29.977052,TraderOne,Tick,241,213,28,-28,147700,147600,5499,-1699,1101,OK
30.266668,TraderOne,Tick,251,213,38,-38,147000,147600,5352,1448,-6152,OK
30.46559,TraderOne,Tick,251,213,38,-38,147000,147600,5352,1448,-6152,OK
30.750107,TraderOne,Tick,251,213,38,-38,147000,147400,5352,1448,-6152,OK
30.994315,TraderOne,Tick,261,213,48,-48,147000,147400,5646,4154,-5446,OK
31.286601,TraderOne,Tick,261,213,48,-48,147000,147400,5646,4154,-5446,OK
31.50145,TraderOne,Tick,271,213,58,-58,147000,147400,5940,7860,-3740,OK
31.703075,TraderOne,Tick,271,213,58,-58,147000,147400,5940,7860,-3740,OK
31.986686,TraderOne,Tick,281,213,68,-68,147000,147400,5793,13007,-593,OK
32.244515,TraderOne,Tick,281,213,68,-68,147000,147400,5793,13007,-593,OK
32.469623,TraderOne,Tick,281,223,58,-58,147100,147400,6087,6713,-4887,OK
32.773406,TraderOne,Tick,281,223,58,-58,147100,147600,6087,6713,-4887,OK
32.980885,TraderOne,Tick,281,233,48,-48,147000,147600,6381,1419,-8181,OK
33.227545,TraderOne,Tick,281,233,48,-48,147000,147600,6381,1419,-8181,OK
33.54858,TraderOne,Tick,281,233,48,-48,147000,147600,6381,1419,-8181,OK
33.766144,TraderOne,Tick,281,243,38,-38,146900,147600,6675,-2875,-10475,OK
33.984294,TraderOne,Tick,281,243,38,-38,146900,147600,6675,-2875,-10475,OK
34.270953,TraderOne,Tick,281,243,38,-38,146900,147200,6675,-2875,-10475,OK
34.470188,TraderOne,Tick,281,243,38,-38,146900,147200,6675,-2875,-10475,OK
34.772689,TraderOne,Tick,281,243,38,-38,146900,147200,6675,-2875,-10475,OK
34.979609,TraderOne,Tick,281,243,38,-38,146900,147200,6675,-2875,-10475,OK
35.268977,TraderOne,Tick,281,243,38,-38,146900,147300,6675,-2875,-10475,OK
35.505714,TraderOne,Tick,281,253,28,-28,147100,147200,6528,-7728,-10528,OK
35.74775,TraderOne,Tick,281,263,18,-18,147200,147000,6822,-8022,-4422,OK
35.995702,TraderOne,Tick,281,263,18,-18,147200,147000,6822,-8022,-4422,OK
36.251711,TraderOne,Tick,281,263,18,-18,147200,147000,6822,-8022,-4422,OK
36.476206,TraderOne,Tick,281,270,11,-11,147200,147000,7028,-8928,-6728,OK
36.797047,TraderOne,Tick,281,270,11,-11,147200,147000,7028,-8928,-6728,OK
36.972231,TraderOne,Tick,281,270,11,-11,147200,147000,7028,-8928,-6728,OK
37.258207,TraderOne,Tick,281,270,11,-11,147200,147000,7028,-8928,-6728,OK
37.52948,TraderOne,Tick,281,270,11,-11,147200,147300,7028,-8928,-10028,OK
37.709126,TraderOne,Tick,281,270,11,-11,147200,147300,7028,-8928,-10028,OK
37.974872,TraderOne,Tick,281,270,11,-11,147200,147300,7028,-8928,-10028,OK
38.267821,TraderOne,Tick,281,270,11,-11,147200,147300,7028,-8928,-10028,OK
38.538403,TraderOne,Tick,281,270,11,-11,147200,147300,7028,-8928,-10028,OK
38.757866,TraderOne,Tick,281,270,11,-11,147200,147300,7028,-8928,-10028,OK
39.005598,TraderOne,Tick,281,270,11,-11,147200,147300,7028,-8928,-10028,OK
39.204809,TraderOne,Tick,291,270,21,-21,147000,147300,6881,-7781,-11981,OK
39.494456,TraderOne,Tick,291,280,11,-11,147700,147300,6733,-8633,-6433,OK
39.711138,TraderOne,Tick,291,280,11,-11,147700,147300,6733,-8633,-6433,OK
39.968493,TraderOne,Tick,291,280,11,-11,147700,147300,6733,-8633,-6433,OK
40.271178,TraderOne,Tick,291,280,11,-11,147700,147300,6733,-8633,-6433,OK
40.502635,TraderOne,Tick,291,290,1,-1,147700,147300,6586,-7486,-7286,OK
40.760746,TraderOne,Tick,291,290,1,-1,147700,147300,6586,-7486,-7286,OK
41.034654,TraderOne,Tick,291,290,1,-1,147700,147300,6586,-7486,-7286,OK
41.226451,TraderOne,Tick,291,290,1,-1,147700,147300,6586,-7486,-7286,OK
41.512477,TraderOne,Tick,291,290,1,-1,147700,147300,6586,-7486,-7286,OK
41.742031,TraderOne,Tick,291,290,1,-1,147700,147300,6586,-7486,-7286,OK
42.045267,TraderOne,Tick,291,290,1,-1,147700,147200,6586,-7486,-7286,OK
42.263633,TraderOne,Tick,291,298,-7,7,147400,147200,6468,-7368,-8768,OK
42.517683,TraderOne,Tick,291,298,-7,7,147400,147200,6468,-7368,-8768,OK
42.702807,TraderOne,Tick,291,298,-7,7,147400,147200,6468,-7368,-8768,OK
42.976636,TraderOne,Tick,291,298,-7,7,147400,147200,6468,-7368,-8768,OK
43.223212,TraderOne,Tick,291,298,-7,7,147400,147200,6468,-7368,-8768,OK
43.497544,TraderOne,Tick,291,298,-7,7,147400,147200,6468,-7368,-8768,OK
43.70952,TraderOne,Tick,291,298,-7,7,147400,147400,6468,-7368,-7368,OK
43.981064,TraderOne,Tick,291,298,-7,7,147400,147400,6468,-7368,-7368,OK
44.266019,TraderOne,Tick,291,298,-7,7,147400,147400,6468,-7368,-7368,OK
44.531406,TraderOne,Tick,291,298,-7,7,147400,147400,6468,-7368,-7368,OK
44.771699,TraderOne,Tick,291,298,-7,7,147400,147400,6468,-7368,-7368,OK
45.00219,TraderOne,Tick,291,298,-7,7,147700,147400,6468,-7368,-8768,OK
45.225862,TraderOne,Tick,291,298,-7,7,147700,147500,6468,-7368,-8768,OK
45.458162,TraderOne,Tick,291,298,-7,7,147700,147500,6468,-7368,-8768,OK
45.790267,TraderOne,Tick,291,308,-17,17,147400,147500,6763,-6663,-4963,OK
45.964669,TraderOne,Tick,291,308,-17,17,147400,147500,6763,-6663,-4963,OK
46.236634,TraderOne,Tick,291,308,-17,17,147400,147500,6763,-6663,-4963,OK
46.542786,TraderOne,Tick,291,308,-17,17,147400,147500,6763,-6663,-4963,OK
46.766477,TraderOne,Tick,291,308,-17,17,147400,147500,6763,-6663,-4963,OK
46.956908,TraderOne,Tick,291,316,-25,25,147400,147500,6999,-5299,-2799,OK
47.261018,TraderOne,Tick,291,316,-25,25,147400,147500,6999,-5299,-2799,OK
47.546863,TraderOne,Tick,291,316,-25,25,147400,147500,6999,-5299,-2799,OK
47.742578,TraderOne,Tick,291,326,-35,35,147700,147500,6851,-3151,-10151,OK
48.033929,TraderOne,Tick,291,326,-35,35,147700,147500,6851,-3151,-10151,OK
48.232465,TraderOne,Tick,291,326,-35,35,147700,147500,6851,-3151,-10151,OK
48.529814,TraderOne,Tick,301,326,-25,25,147100,147500,6704,-7004,-2004,OK
48.733762,TraderOne,Tick,301,326,-25,25,147100,147500,6704,-7004,-2004,OK
49.037856,TraderOne,Tick,301,326,-25,25,147100,147500,6704,-7004,-2004,OK
49.276574,TraderOne,Tick,301,326,-25,25,147100,147500,6704,-7004,-2004,OK
49.522356,TraderOne,Tick,311,326,-15,15,147700,147500,6999,-10299,-13299,OK
49.734195,TraderOne,Tick,311,326,-15,15,147700,147500,6999,-10299,-13299,OK
50.044061,TraderOne,Tick,311,326,-15,15,147700,147500,6999,-10299,-13299,OK
50.223944,TraderOne,Tick,311,326,-15,15,147700,147500,6999,-10299,-13299,OK
50.513815,TraderOne,Tick,311,326,-15,15,147700,147500,6999,-10299,-13299,OK
50.761733,TraderOne,Tick,311,326,-15,15,147700,147500,6999,-10299,-13299,OK
51.039594,TraderOne,Tick,311,326,-15,15,147700,147500,6999,-10299,-13299,OK
51.262853,TraderOne,Tick,311,326,-15,15,147700,147500,6999,-10299,-13299,OK
51.535941,TraderOne,Tick,311,326,-15,15,147700,147500,6999,-10299,-13299,OK
51.782606,TraderOne,Tick,311,326,-15,15,147700,147500,6999,-10299,-13299,OK
52.04105,TraderOne,Tick,311,326,-15,15,147700,147300,6999,-10299,-13299,OK
52.252381,TraderOne,Tick,311,326,-15,15,147700,147300,6999,-10299,-13299,OK
52.450706,TraderOne,Tick,311,326,-15,15,147700,147300,6999,-10299,-13299,OK
52.707801,TraderOne,Tick,311,326,-15,15,147700,147300,6999,-10299,-13299,OK
53.017987,TraderOne,Tick,311,326,-15,15,147700,147300,6999,-10299,-13299,OK
53.270233,TraderOne,Tick,311,326,-15,15,147700,147300,6999,-10299,-13299,OK
53.455028,TraderOne,Tick,311,326,-15,15,147700,147300,6999,-10299,-13299,OK
53.711234,TraderOne,Tick,311,326,-15,15,147700,147300,6999,-10299,-13299,OK
54.016556,TraderOne,Tick,311,336,-25,25,147800,147300,6851,-9151,-14151,OK
54.248991,TraderOne,Tick,311,336,-25,25,147800,147300,6851,-9151,-14151,OK
54.549197,TraderOne,Tick,311,336,-25,25,147800,147200,6851,-9151,-14151,OK
54.756722,TraderOne,Tick,311,336,-25,25,147800,147200,6851,-9151,-14151,OK
54.969193,TraderOne,Tick,311,336,-25,25,147800,147200,6851,-9151,-14151,OK
55.280559,TraderOne,Tick,321,336,-15,15,147300,147300,6704,-11004,-11004,OK
55.541664,TraderOne,Tick,321,336,-15,15,147300,146900,6704,-11004,-14004,OK
55.728054,TraderOne,Tick,331,336,-5,5,147300,146900,6557,-14857,-15857,OK
56.042548,TraderOne,Tick,331,346,-15,15,147300,147100,6852,-13152,-16152,OK
56.274213,TraderOne,Tick,331,346,-15,15,147300,147100,6852,-13152,-16152,OK
56.506429,TraderOne,Tick,331,355,-24,24,147300,147100,7117,-11617,-16417,OK
56.794929,TraderOne,Tick,331,355,-24,24,147300,147100,7117,-11617,-16417,OK
57.010957,TraderOne,Tick,331,355,-24,24,147300,147100,7117,-11617,-16417,OK
57.206438,TraderOne,Tick,331,355,-24,24,147300,147100,7117,-11617,-16417,OK
57.452763,TraderOne,Tick,331,355,-24,24,147300,146800,7117,-11617,-16417,OK
57.765445,TraderOne,Tick,331,365,-34,34,147100,146600,7411,-7911,-14711,OK
57.997575,TraderOne,Tick,331,372,-41,41,147100,146600,7617,-5317,-13517,OK
58.264258,TraderOne,Tick,331,372,-41,41,147100,146700,7617,-5317,-13517,OK
58.46487,TraderOne,Tick,331,372,-41,41,147100,146700,7617,-5317,-13517,OK
58.791064,TraderOne,Tick,331,372,-41,41,147100,146700,7617,-5317,-13517,OK
59.037691,TraderOne,Tick,331,372,-41,41,147100,146700,7617,-5317,-13517,OK
59.286719,TraderOne,Tick,331,372,-41,41,147100,146700,7617,-5317,-13517,OK
59.507043,TraderOne,Tick,331,372,-41,41,147100,146500,7617,-5317,-13517,OK
59.772645,TraderOne,Tick,331,372,-41,41,147100,146500,7617,-5317,-13517,OK
60.026144,TraderOne,Tick,331,372,-41,41,147100,146500,7617,-5317,-13517,OK
60.222024,TraderOne,Tick,331,372,-41,41,147100,146700,7617,-5317,-13517,OK
60.512338,TraderOne,Tick,331,372,-41,41,147100,146700,7617,-5317,-13517,OK
60.706057,TraderOne,Tick,331,372,-41,41,147100,146600,7617,-5317,-13517,OK
61.014952,TraderOne,Tick,331,372,-41,41,147100,146500,7617,-5317,-13517,OK
61.237787,TraderOne,Tick,331,372,-41,41,147100,146500,7617,-5317,-13517,OK
61.531103,TraderOne,Tick,331,372,-41,41,147100,146500,7617,-5317,-13517,OK
61.782786,TraderOne,Tick,331,372,-41,41,147100,146500,7617,-5317,-13517,OK
61.998898,TraderOne,Tick,331,372,-41,41,147100,146500,7617,-5317,-13517,OK
62.287024,TraderOne,Tick,331,372,-41,41,147000,146300,7617,-5317,-13517,OK
62.517198,TraderOne,Tick,331,382,-51,51,146700,146300,7911,389,-9811,OK
62.728118,TraderOne,Tick,341,382,-41,41,146800,146300,8205,-5905,-14105,OK
62.987028,TraderOne,Tick,351,382,-31,31,146800,146300,8058,-11758,-17958,OK
63.213385,TraderOne,Tick,351,382,-31,31,146800,146300,8058,-11758,-17958,OK
63.513876,TraderOne,Tick,351,382,-31,31,146800,146300,8058,-11758,-17958,OK
63.730278,TraderOne,Tick,351,382,-31,31,146800,146300,8058,-11758,-17958,OK
64.014357,TraderOne,Tick,351,382,-31,31,146800,146300,8058,-11758,-17958,OK
64.290851,TraderOne,Tick,361,382,-21,21,146700,146300,8352,-15052,-19252,OK
64.537472,TraderOne,Tick,361,382,-21,21,146700,146300,8352,-15052,-19252,OK
64.775666,TraderOne,Tick,361,382,-21,21,146700,146300,8352,-15052,-19252,OK
65.012283,TraderOne,Tick,361,382,-21,21,146700,146300,8352,-15052,-19252,OK
65.244798,TraderOne,Tick,361,382,-21,21,146700,146900,8352,-15052,-10852,OK
65.453982,TraderOne,Tick,361,382,-21,21,146700,146900,8352,-15052,-10852,OK
65.705849,TraderOne,Tick,361,382,-21,21,146700,146900,8352,-15052,-10852,OK
66.003204,TraderOne,Tick,371,382,-11,11,146600,146900,8205,-17905,-15705,OK
66.288477,TraderOne,Tick,371,382,-11,11,146600,146900,8205,-17905,-15705,OK
66.493433,TraderOne,Tick,371,392,-21,21,147300,146900,8058,-14758,-18958,OK
66.753262,TraderOne,Tick,381,392,-11,11,146500,146900,7911,-16611,-14411,OK
67.046553,TraderOne,Tick,381,392,-11,11,146500,146900,7911,-16611,-14411,OK
67.240033,TraderOne,Tick,381,392,-11,11,146500,146900,7911,-16611,-14411,OK
67.481896,TraderOne,Tick,381,392,-11,11,146500,146900,7911,-16611,-14411,OK
67.737191,TraderOne,Tick,391,392,-1,1,146900,146900,8205,-18905,-18905,OK
67.992829,TraderOne,Tick,391,392,-1,1,146900,146900,8205,-18905,-18905,OK
68.209977,TraderOne,Tick,391,392,-1,1,146900,146900,8205,-18905,-18905,OK
68.533019,TraderOne,Tick,401,402,-1,1,146500,146900,7911,-19611,-19411,OK
68.711844,TraderOne,Tick,401,402,-1,1,146500,147200,7911,-19611,-19411,OK
69.011839,TraderOne,Tick,401,402,-1,1,146500,147200,7911,-19611,-19411,OK
69.214251,TraderOne,Tick,401,412,-11,11,147500,147200,7764,-18464,-20664,OK
69.5393,TraderOne,Tick,401,412,-11,11,147500,147200,7764,-18464,-20664,OK
69.770145,TraderOne,Tick,401,412,-11,11,147500,147300,7764,-18464,-20664,OK
69.967453,TraderOne,Tick,401,412,-11,11,147500,147300,7764,-18464,-20664,OK
70.299873,TraderOne,Tick,401,412,-11,11,147500,147300,7764,-18464,-20664,OK
70.473997,TraderOne,Tick,401,412,-11,11,147500,147300,7764,-18464,-20664,OK
70.755526,TraderOne,Tick,411,412,-1,1,146500,147300,7617,-20317,-20117,OK
71.029499,TraderOne,Tick,411,412,-1,1,146500,147300,7617,-20317,-20117,OK
71.260618,TraderOne,Tick,411,412,-1,1,146500,147300,7617,-20317,-20117,OK
71.545833,TraderOne,Tick,411,412,-1,1,146500,147300,7617,-20317,-20117,OK
71.725398,TraderOne,Tick,411,412,-1,1,146500,147300,7617,-20317,-20117,OK
72.042652,TraderOne,Tick,411,412,-1,1,146500,147300,7617,-20317,-20117,OK
72.212734,TraderOne,Tick,411,412,-1,1,146500,147300,7617,-20317,-20117,OK
72.465812,TraderOne,Tick,411,422,-11,11,147500,147300,7470,-20170,-22370,OK
72.707798,TraderOne,Tick,411,422,-11,11,147500,147300,7470,-20170,-22370,OK
73.003791,TraderOne,Tick,411,422,-11,11,147600,147300,7470,-20170,-22370,OK
73.202854,TraderOne,Tick,411,422,-11,11,147600,147300,7470,-20170,-22370,OK
73.54867,TraderOne,Tick,411,422,-11,11,147600,147200,7470,-20170,-22370,OK
73.790454,TraderOne,Tick,411,422,-11,11,147600,147200,7470,-20170,-22370,OK
74.047127,TraderOne,Tick,411,422,-11,11,147600,147200,7470,-20170,-22370,OK
74.233492,TraderOne,Tick,421,422,-1,1,147600,147200,7765,-22465,-22665,OK
74.545349,TraderOne,Tick,421,422,-1,1,147600,147200,7765,-22465,-22665,OK
74.712892,TraderOne,Tick,421,422,-1,1,147600,147200,7765,-22465,-22665,OK
75.034751,TraderOne,Tick,421,422,-1,1,147600,147200,7765,-22465,-22665,OK
75.236918,TraderOne,Tick,421,432,-11,11,147500,147400,8060,-22760,-23860,OK
75.54168,TraderOne,Tick,421,432,-11,11,147500,147400,8060,-22760,-23860,OK
75.748313,TraderOne,Tick,421,432,-11,11,147500,147400,8060,-22760,-23860,OK
75.980038,TraderOne,Tick,421,432,-11,11,147500,147400,8060,-22760,-23860,OK
76.238168,TraderOne,Tick,421,432,-11,11,147500,147400,8060,-22760,-23860,OK
76.465468,TraderOne,Tick,421,432,-11,11,147500,147500,8060,-22760,-22760,OK
76.773247,TraderOne,Tick,431,432,-1,1,147600,147600,8355,-24055,-24055,OK
76.965905,TraderOne,Tick,431,432,-1,1,147600,147600,8355,-24055,-24055,OK
77.291203,TraderOne,Tick,431,442,-11,11,147500,147600,8650,-23350,-22250,OK
77.480928,TraderOne,Tick,431,442,-11,11,147500,147600,8650,-23350,-22250,OK
77.734172,TraderOne,Tick,441,442,-1,1,147400,147600,8503,-25203,-25003,OK
78.027327,TraderOne,Tick,441,442,-1,1,147400,147600,8503,-25203,-25003,OK
78.267329,TraderOne,Tick,441,442,-1,1,147400,147600,8503,-25203,-25003,OK
78.543076,TraderOne,Tick,451,442,9,-9,147400,147600,8798,-26498,-28298,OK
78.766098,TraderOne,Tick,451,442,9,-9,147400,147600,8798,-26498,-28298,OK
78.960572,TraderOne,Tick,451,442,9,-9,147400,147600,8798,-26498,-28298,OK
79.214545,TraderOne,Tick,461,442,19,-19,147400,147600,9093,-24793,-28593,OK
79.47851,TraderOne,Tick,463,442,21,-21,147400,147600,9152,-24452,-28652,OK
79.776581,TraderOne,Tick,473,442,31,-31,147600,148500,9447,-22747,-28947,OK
80.000977,TraderOne,Tick,483,442,41,-41,147900,148400,9742,-16642,-24842,OK
80.215791,TraderOne,Tick,483,442,41,-41,147900,148400,9742,-16642,-24842,OK
80.54594,TraderOne,Tick,483,442,41,-41,147900,148400,9742,-16642,-24842,OK
80.752323,TraderOne,Tick,483,442,41,-41,147900,148400,9742,-16642,-24842,OK
80.982731,TraderOne,Tick,493,442,51,-51,147900,148400,10038,-12938,-23138,OK
81.246012,TraderOne,Tick,493,442,51,-51,147900,148300,10038,-12938,-23138,OK
81.450891,TraderOne,Tick,493,442,51,-51,147900,148400,10038,-12938,-23138,OK
81.759857,TraderOne,Tick,503,442,61,-61,148000,148400,10334,-8234,-20434,OK
82.01853,TraderOne,Tick,503,442,61,-61,148000,148400,10334,-8234,-20434,OK
82.277035,TraderOne,Tick,503,442,61,-61,148000,148400,10334,-8234,-20434,OK
82.529511,TraderOne,Tick,503,452,51,-51,148200,148800,10186,-15086,-25286,OK
82.778421,TraderOne,Tick,503,452,51,-51,148200,148800,10186,-15086,-25286,OK
82.989136,TraderOne,Tick,503,452,51,-51,148200,148800,10186,-15086,-25286,OK
83.287343,TraderOne,Tick,503,452,51,-51,148300,148800,10186,-15086,-25286,OK
83.514519,TraderOne,Tick,503,452,51,-51,148300,148800,10186,-15086,-25286,OK
83.749775,TraderOne,Tick,503,452,51,-51,148300,148800,10186,-15086,-25286,OK
83.986008,TraderOne,Tick,503,452,51,-51,148400,149000,10186,-15086,-25286,OK
84.225129,TraderOne,Tick,513,452,61,-61,148500,149000,10483,-10383,-22583,OK
84.536724,TraderOne,Tick,513,452,61,-61,148500,149000,10483,-10383,-22583,OK
84.751793,TraderOne,Tick,513,452,61,-61,148500,149200,10483,-10383,-22583,OK
84.993003,TraderOne,Tick,519,462,57,-57,148600,149200,10512,-13812,-25212,OK
85.254577,TraderOne,Tick,529,462,67,-67,148600,149200,10363,-8663,-22063,OK
85.545184,TraderOne,Tick,529,472,57,-57,148800,149200,10660,-14960,-26360,OK
85.795334,TraderOne,Tick,529,482,47,-47,148700,149200,10511,-21811,-31211,OK
86.003263,TraderOne,Tick,539,482,57,-57,148800,149600,10809,-17109,-28509,OK
86.252291,TraderOne,Tick,539,492,47,-47,149000,149600,10660,-23960,-33360,OK
86.505794,TraderOne,Tick,539,492,47,-47,149000,149600,10660,-23960,-33360,OK
86.708867,TraderOne,Tick,539,502,37,-37,149600,149600,10511,-26811,-26811,OK
87.034011,TraderOne,Tick,539,502,37,-37,149600,149600,10511,-26811,-26811,OK
87.239959,TraderOne,Tick,539,502,37,-37,149600,149600,10511,-26811,-26811,OK
87.452517,TraderOne,Tick,539,502,37,-37,149600,149700,10511,-26811,-30511,OK
87.702359,TraderOne,Tick,539,502,37,-37,149600,149700,10511,-26811,-30511,OK
88.041394,TraderOne,Tick,539,502,37,-37,149600,149500,10511,-26811,-23111,OK
88.298356,TraderOne,Tick,539,502,37,-37,149600,149500,10511,-26811,-23111,OK
88.510485,TraderOne,Tick,539,502,37,-37,149600,149200,10511,-26811,-19411,OK
88.792095,TraderOne,Tick,539,502,37,-37,149600,149100,10511,-26811,-19411,OK
88.964852,TraderOne,Tick,539,502,37,-37,149600,149100,10511,-26811,-19411,OK
89.244854,TraderOne,Tick,539,502,37,-37,149600,149100,10511,-26811,-19411,OK
89.544175,TraderOne,Tick,539,502,37,-37,149600,148900,10511,-26811,-19411,OK
89.774388,TraderOne,Tick,539,502,37,-37,149600,148900,10511,-26811,-19411,OK
90.002304,TraderOne,Tick,539,502,37,-37,149600,148900,10511,-26811,-19411,OK
90.258306,TraderOne,Tick,539,502,37,-37,149600,149100,10511,-26811,-19411,OK
90.542619,TraderOne,Tick,539,502,37,-37,149600,149100,10511,-26811,-19411,OK
90.722684,TraderOne,Tick,539,502,37,-37,149600,149100,10511,-26811,-19411,OK
90.960047,TraderOne,Tick,539,512,27,-27,148800,149100,10362,-29662,-35062,OK
91.201448,TraderOne,Tick,539,522,17,-17,149400,149100,10661,-26961,-23561,OK
91.48085,TraderOne,Tick,539,527,12,-12,149400,148900,10810,-25110,-22710,OK
91.742006,TraderOne,Tick,539,536,3,-3,148800,148900,10676,-27676,-27976,OK
91.999216,TraderOne,Tick,539,537,2,-2,149600,148900,10661,-27961,-27561,OK
92.253889,TraderOne,Tick,549,537,12,-12,148500,148900,10512,-27812,-30212,OK
92.465941,TraderOne,Tick,549,537,12,-12,148500,148900,10512,-27812,-30212,OK
92.7531,TraderOne,Tick,549,537,12,-12,148500,148900,10512,-27812,-30212,OK
92.978196,TraderOne,Tick,549,537,12,-12,148500,148900,10512,-27812,-30212,OK
93.201119,TraderOne,Tick,549,537,12,-12,148500,149200,10512,-27812,-30212,OK
93.504343,TraderOne,Tick,549,537,12,-12,148500,149200,10512,-27812,-30212,OK
93.7936,TraderOne,Tick,549,537,12,-12,148500,149200,10512,-27812,-30212,OK
93.982131,TraderOne,Tick,549,537,12,-12,148500,149200,10512,-27812,-30212,OK
94.294369,TraderOne,Tick,549,537,12,-12,148500,149200,10512,-27812,-30212,OK
94.508272,TraderOne,Tick,549,537,12,-12,148500,149200,10512,-27812,-30212,OK
94.745594,TraderOne,Tick,549,537,12,-12,148500,149200,10512,-27812,-30212,OK
94.976818,TraderOne,Tick,549,537,12,-12,148500,149200,10512,-27812,-30212,OK
95.269155,TraderOne,Tick,549,537,12,-12,148500,149200,10512,-27812,-30212,OK
95.451568,TraderOne,Tick,549,537,12,-12,148500,149200,10512,-27812,-30212,OK
95.765166,TraderOne,Tick,549,537,12,-12,148500,149200,10512,-27812,-30212,OK
95.991323,TraderOne,Tick,549,537,12,-12,148500,149200,10512,-27812,-30212,OK
96.223963,TraderOne,Tick,549,537,12,-12,148500,149200,10512,-27812,-30212,OK
96.48519,TraderOne,Tick,549,537,12,-12,148500,149200,10512,-27812,-30212,OK
96.766942,TraderOne,Tick,549,537,12,-12,148500,149200,10512,-27812,-30212,OK
97.008041,TraderOne,Tick,556,537,19,-19,149600,149200,10721,-27321,-23521,OK
97.230062,TraderOne,Tick,556,537,19,-19,149600,149200,10721,-27321,-23521,OK
97.510168,TraderOne,Tick,566,547,19,-19,149800,149600,10421,-27021,-23221,OK
97.765405,TraderOne,Tick,566,547,19,-19,149800,149800,10421,-27021,-27021,OK
97.962015,TraderOne,Tick,566,547,19,-19,149800,149800,10421,-27021,-27021,OK
98.216092,TraderOne,Tick,566,547,19,-19,149800,149800,10421,-27021,-27021,OK
98.45612,TraderOne,Tick,566,547,19,-19,149800,149800,10421,-27021,-27021,OK
98.784043,TraderOne,Tick,576,547,29,-29,149800,149800,10271,-25871,-25871,OK
99.038888,TraderOne,Tick,576,547,29,-29,149800,149900,10271,-25871,-28771,OK
99.263621,TraderOne,Tick,576,547,29,-29,149800,150100,10271,-25871,-34571,OK
99.497507,TraderOne,Tick,586,547,39,-39,149800,150100,10571,-24171,-35871,OK
99.765425,TraderOne,Tick,586,547,39,-39,149800,150000,10571,-24171,-31971,OK
100.001651,TraderOne,Tick,586,557,29,-29,149900,150000,10421,-27021,-29921,OK
100.284491,TraderOne,Tick,586,557,29,-29,149900,149900,10421,-27021,-27021,OK
100.540247,TraderOne,Tick,586,557,29,-29,149900,149900,10421,-27021,-27021,OK
100.702049,TraderOne,Tick,586,557,29,-29,149900,149900,10421,-27021,-27021,OK
100.997564,TraderOne,Tick,586,557,29,-29,149900,149900,10421,-27021,-27021,OK
101.279171,TraderOne,Tick,596,557,39,-39,149400,149900,10271,-24871,-36571,OK
101.454398,TraderOne,Tick,596,557,39,-39,149400,150100,10271,-24871,-36571,OK
101.726453,TraderOne,Tick,596,557,39,-39,149400,150100,10271,-24871,-36571,OK
102.013909,TraderOne,Tick,596,557,39,-39,149400,150100,10271,-24871,-36571,OK
102.289624,TraderOne,Tick,596,557,39,-39,149400,150100,10271,-24871,-36571,OK
102.453994,TraderOne,Tick,596,557,39,-39,149400,150100,10271,-24871,-36571,OK
102.778533,TraderOne,Tick,606,557,49,-49,149900,150300,10571,-22171,-36871,OK
102.998092,TraderOne,Tick,606,557,49,-49,149900,150300,10571,-22171,-36871,OK
103.264235,TraderOne,Tick,606,557,49,-49,149900,150300,10571,-22171,-36871,OK
103.493894,TraderOne,Tick,610,567,43,-43,149900,150300,10361,-24961,-37861,OK
103.748827,TraderOne,Tick,610,569,41,-41,150100,150300,10421,-25621,-33821,OK
104.036701,TraderOne,Tick,610,569,41,-41,150100,150400,10421,-25621,-37921,OK
104.22308,TraderOne,Tick,610,569,41,-41,150100,150400,10421,-25621,-37921,OK
104.549648,TraderOne,Tick,610,569,41,-41,150100,150200,10421,-25621,-29721,OK
104.747569,TraderOne,Tick,610,569,41,-41,150100,150200,10421,-25621,-29721,OK
104.963585,TraderOne,Tick,610,569,41,-41,150100,150200,10421,-25621,-29721,OK
105.287442,TraderOne,Tick,610,569,41,-41,150100,150200,10421,-25621,-29721,OK
105.542054,TraderOne,Tick,610,569,41,-41,150100,150200,10421,-25621,-29721,OK
105.774896,TraderOne,Tick,610,569,41,-41,150100,150200,10421,-25621,-29721,OK
105.997588,TraderOne,Tick,610,569,41,-41,150100,150300,10421,-25621,-33821,OK
106.244883,TraderOne,Tick,610,579,31,-31,150000,150500,10271,-31471,-40771,OK
106.455189,TraderOne,Tick,620,579,41,-41,150200,150500,10121,-28321,-40621,OK
106.76896,TraderOne,Tick,620,579,41,-41,150200,150400,10121,-28321,-36521,OK
107.043634,TraderOne,Tick,620,579,41,-41,150200,150300,10121,-28321,-32421,OK
107.261625,TraderOne,Tick,620,579,41,-41,150200,150300,10121,-28321,-32421,OK
107.54026,TraderOne,Tick,620,579,41,-41,150200,150400,10121,-28321,-36521,OK
107.75946,TraderOne,Tick,620,579,41,-41,150200,150400,10121,-28321,-36521,OK
108.038002,TraderOne,Tick,620,579,41,-41,150200,150400,10121,-28321,-36521,OK
108.26847,TraderOne,Tick,620,579,41,-41,150200,150300,10121,-28321,-32421,OK
108.523275,TraderOne,Tick,620,579,41,-41,150200,150100,10121,-28321,-24221,OK
108.715124,TraderOne,Tick,620,589,31,-31,149800,150100,10421,-33621,-42921,OK
109.001545,TraderOne,Tick,630,599,31,-31,149600,150100,10571,-33771,-43071,OK
109.231124,TraderOne,Tick,630,599,31,-31,149600,150100,10571,-33771,-43071,OK
109.479134,TraderOne,Tick,630,599,31,-31,149600,150100,10571,-33771,-43071,OK
109.760961,TraderOne,Tick,630,609,21,-21,149900,150100,10421,-36621,-40821,OK
109.974904,TraderOne,Tick,630,619,11,-11,150100,150100,10721,-36921,-36921,OK
110.267098,TraderOne,Tick,630,629,1,-1,150200,150500,11021,-39221,-39521,OK
110.458253,TraderOne,Tick,640,629,11,-11,150200,150500,11321,-37521,-40821,OK
110.745641,TraderOne,Tick,650,629,21,-21,150200,150700,11621,-34821,-41121,OK
110.963987,TraderOne,Tick,660,629,31,-31,150200,150600,11921,-31121,-40421,OK
111.230423,TraderOne,Tick,670,629,41,-41,150200,150600,12221,-27421,-39721,OK
111.487378,TraderOne,Tick,680,639,41,-41,150600,150600,12371,-27571,-27571,OK
111.782846,TraderOne,Tick,680,639,41,-41,150100,150600,12371,-27571,-39871,OK
112.03625,TraderOne,Tick,680,639,41,-41,150100,150600,12371,-27571,-39871,OK
112.276846,TraderOne,Tick,680,639,41,-41,150100,150500,12371,-27571,-39871,OK
112.474518,TraderOne,Tick,680,649,31,-31,150100,150400,12671,-31871,-41171,OK
112.739209,TraderOne,Tick,680,649,31,-31,150100,150500,12671,-31871,-41171,OK
112.978717,TraderOne,Tick,680,649,31,-31,150100,150700,12671,-31871,-41171,OK
113.221857,TraderOne,Tick,680,649,31,-31,150100,150600,12671,-31871,-41171,OK
113.496848,TraderOne,Tick,680,649,31,-31,150100,150500,12671,-31871,-41171,OK
113.794368,TraderOne,Tick,680,649,31,-31,150100,150500,12671,-31871,-41171,OK
113.996994,TraderOne,Tick,680,649,31,-31,150100,150500,12671,-31871,-41171,OK
114.202893,TraderOne,Tick,680,649,31,-31,150100,150600,12671,-31871,-41171,OK
114.534861,TraderOne,Tick,680,659,21,-21,150500,150500,12521,-34721,-34721,OK
114.719036,TraderOne,Tick,680,659,21,-21,150500,150500,12521,-34721,-34721,OK
115.021981,TraderOne,Tick,680,659,21,-21,150500,150900,12521,-34721,-41021,OK
115.21065,TraderOne,Tick,690,659,31,-31,150500,150500,12822,-33022,-33022,OK
115.50733,TraderOne,Tick,690,666,24,-24,150100,150500,13032,-35332,-42532,OK
115.739793,TraderOne,Tick,690,666,24,-24,150100,150500,13032,-35332,-42532,OK
115.963537,TraderOne,Tick,690,666,24,-24,150100,150400,13032,-35332,-42532,OK
116.227703,TraderOne,Tick,690,676,14,-14,150600,150500,12882,-37182,-35782,OK
116.473375,TraderOne,Tick,690,676,14,-14,150600,150800,12882,-37182,-39982,OK
116.795255,TraderOne,Tick,690,676,14,-14,150600,150500,12882,-37182,-35782,OK
116.975034,TraderOne,Tick,700,676,24,-24,150000,150500,12732,-36032,-43232,OK
117.206782,TraderOne,Tick,700,676,24,-24,150000,150500,12732,-36032,-43232,OK
117.501702,TraderOne,Tick,700,676,24,-24,150000,150300,12732,-36032,-43232,OK
117.756912,TraderOne,Tick,700,676,24,-24,150000,150300,12732,-36032,-43232,OK
118.024444,TraderOne,Tick,700,676,24,-24,150000,150300,12732,-36032,-43232,OK
118.207739,TraderOne,Tick,700,676,24,-24,150000,150300,12732,-36032,-43232,OK
118.451405,TraderOne,Tick,700,686,14,-14,150300,150500,12582,-37882,-40682,OK
118.706119,TraderOne,Tick,700,693,7,-7,150500,150400,12793,-38793,-38093,OK
119.018318,TraderOne,Tick,710,693,17,-17,150300,150300,12643,-38643,-38643,OK
119.25097,TraderOne,Tick,720,693,27,-27,150200,150300,12943,-37943,-40643,OK
119.535818,TraderOne,Tick,720,693,27,-27,150200,150300,12943,-37943,-40643,OK
119.776902,TraderOne,Tick,720,694,26,-26,150100,150100,12928,-38128,-38128,OK
120.007168,TraderOne,Tick,720,694,26,-26,150100,150100,12928,-38128,-38128,OK
120.209483,TraderOne,Tick,720,704,16,-16,150200,150600,12778,-45978,-50778,OK
120.485239,TraderOne,Tick,720,704,16,-16,150200,150600,12778,-45978,-50778,OK
120.771812,TraderOne,Tick,720,704,16,-16,150200,150600,12778,-45978,-50778,OK
121.017742,TraderOne,Tick,720,704,16,-16,150200,150600,12778,-45978,-50778,OK
121.232798,TraderOne,Tick,730,704,26,-26,150000,150600,12628,-44828,-52628,OK
121.457015,TraderOne,Tick,740,704,36,-36,150400,150600,12478,-43678,-50878,OK
121.750038,TraderOne,Tick,740,704,36,-36,150400,150600,12478,-43678,-50878,OK
121.994718,TraderOne,Tick,740,704,36,-36,150400,150600,12478,-43678,-50878,OK
122.278512,TraderOne,Tick,750,704,46,-46,150100,150600,12328,-41528,-55328,OK
122.538047,TraderOne,Tick,750,704,46,-46,150100,150500,12328,-41528,-55328,OK
122.789857,TraderOne,Tick,750,704,46,-46,150100,150500,12328,-41528,-55328,OK
123.049904,TraderOne,Tick,750,704,46,-46,150100,150500,12328,-41528,-55328,OK
123.24583,TraderOne,Tick,750,704,46,-46,150100,150400,12328,-41528,-55328,OK
123.515145,TraderOne,Tick,750,704,46,-46,150100,150400,12328,-41528,-55328,OK
123.763202,TraderOne,Tick,750,714,36,-36,150400,150400,12178,-45378,-45378,OK
123.999635,TraderOne,Tick,750,724,26,-26,150400,150400,12028,-48228,-48228,OK
124.236732,TraderOne,Tick,750,734,16,-16,150400,150400,12329,-49529,-49529,OK
124.519057,TraderOne,Tick,750,744,6,-6,150600,150400,12630,-50830,-49630,OK
124.771573,TraderOne,Tick,750,744,6,-6,150600,150400,12630,-50830,-49630,OK
125.037229,TraderOne,Tick,750,744,6,-6,150600,150400,12630,-50830,-49630,OK
125.274666,TraderOne,Tick,750,744,6,-6,150600,150400,12630,-50830,-49630,OK
125.455137,TraderOne,Tick,750,744,6,-6,150400,150400,12630,-50830,-50830,OK
125.781383,TraderOne,Tick,750,744,6,-6,150400,150400,12630,-50830,-50830,OK
126.016857,TraderOne,Tick,760,744,16,-16,150500,150700,12931,-50131,-53331,OK
126.278933,TraderOne,Tick,770,744,26,-26,150500,151100,13232,-49432,-57232,OK
126.478677,TraderOne,Tick,780,744,36,-36,150500,151200,13533,-43733,-54533,OK
126.741327,TraderOne,Tick,790,744,46,-46,150500,151000,13834,-39034,-52834,OK
127.008223,TraderOne,Tick,790,744,46,-46,150500,151000,13834,-39034,-52834,OK
127.28889,TraderOne,Tick,790,744,46,-46,150500,151000,13834,-39034,-52834,OK
127.548842,TraderOne,Tick,790,744,46,-46,150500,150700,13834,-39034,-48234,OK
127.776926,TraderOne,Tick,790,754,36,-36,150400,150400,14135,-41335,-41335,OK
128.027064,TraderOne,Tick,790,764,26,-26,150400,150300,14436,-41636,-39036,OK
128.25358,TraderOne,Tick,790,764,26,-26,150400,150300,14436,-41636,-39036,OK
128.476819,TraderOne,Tick,790,764,26,-26,150400,150200,14436,-41636,-36436,OK
128.74305,TraderOne,Tick,790,764,26,-26,150400,150200,14436,-41636,-36436,OK
128.954983,TraderOne,Tick,790,764,26,-26,150400,150200,14436,-41636,-36436,OK
129.27704,TraderOne,Tick,790,764,26,-26,150400,150200,14436,-41636,-36436,OK
129.49137,TraderOne,Tick,790,774,16,-16,150900,150400,14286,-43486,-38686,OK
129.764224,TraderOne,Tick,790,774,16,-16,150900,150400,14286,-43486,-38686,OK
129.982236,TraderOne,Tick,790,774,16,-16,150900,150400,14286,-43486,-38686,OK
130.253158,TraderOne,Tick,790,774,16,-16,150900,150400,14286,-43486,-38686,OK
130.487487,TraderOne,Tick,790,774,16,-16,150900,150400,14286,-43486,-38686,OK
130.746809,TraderOne,Tick,790,774,16,-16,150900,150400,14286,-43486,-38686,OK
131.041317,TraderOne,Tick,800,774,26,-26,149800,150400,14136,-43336,-51136,OK
131.201272,TraderOne,Tick,800,774,26,-26,149800,150400,14136,-43336,-51136,OK
131.476987,TraderOne,Tick,800,774,26,-26,149800,150100,14136,-43336,-51136,OK
131.796633,TraderOne,Tick,800,774,26,-26,149800,150100,14136,-43336,-51136,OK
132.040587,TraderOne,Tick,800,784,16,-16,150800,150100,13986,-45186,-40386,OK
132.207183,TraderOne,Tick,800,784,16,-16,150800,149800,13986,-45186,-40386,OK
132.54872,TraderOne,Tick,800,794,6,-6,149800,149800,14286,-45486,-45486,OK
132.726607,TraderOne,Tick,800,804,-4,4,149800,149600,14586,-43786,-44586,OK
133.047627,TraderOne,Tick,800,814,-14,14,149800,149600,14886,-43086,-45886,OK
133.251117,TraderOne,Tick,800,824,-24,24,150200,149600,14736,-40936,-45736,OK
133.518281,TraderOne,Tick,800,824,-24,24,150200,149600,14736,-40936,-45736,OK
133.797316,TraderOne,Tick,810,824,-14,14,149000,149500,14586,-43786,-40986,OK
134.020385,TraderOne,Tick,810,824,-14,14,149000,149600,14586,-43786,-40986,OK
134.263084,TraderOne,Tick,810,824,-14,14,149000,149600,14586,-43786,-40986,OK
134.513219,TraderOne,Tick,810,824,-14,14,149000,149700,14586,-43786,-40986,OK
134.704718,TraderOne,Tick,810,824,-14,14,149000,149700,14586,-43786,-40986,OK
134.990707,TraderOne,Tick,810,824,-14,14,149000,149800,14586,-43786,-39586,OK
135.252163,TraderOne,Tick,810,824,-14,14,149000,149800,14586,-43786,-39586,OK
135.474099,TraderOne,Tick,830,826,4,-4,149900,149800,14256,-47056,-46656,OK
135.800232,TraderOne,Tick,840,826,14,-14,149300,149900,14555,-42355,-46555,OK
135.959469,TraderOne,Tick,840,826,14,-14,149300,149900,14555,-42355,-46555,OK
136.296024,TraderOne,Tick,840,826,14,-14,149300,149900,14555,-42355,-46555,OK
136.476057,TraderOne,Tick,840,826,14,-14,149300,149900,14555,-42355,-46555,OK
136.729686,TraderOne,Tick,840,826,14,-14,149300,149800,14555,-42355,-46555,OK
137.0264,TraderOne,Tick,840,826,14,-14,149300,149600,14555,-42355,-45155,OK
